かお	顔	face
ひょうじょう	表情	expression
おこる	怒る	to get angry
へんな	変な	strange
たいへんな	大変な	tough; hectic
あいて	相手	partner
よこ	横	side
くらべる	比べる	to compare
ぶんか	文化	culture
ちがう	違う	different
まちがえる	間違える	to make a mistake
かなしい	悲しい	sad
ちょうさ	調査	survey; research
しらべる	調べる	to look into
ちょうさ	調査	survey; research
かっか	結果	result
かんじょう	感情	emotion
かんどうする	感動する	to be moved
こたえる	答える	to answer
こたえ	答え	answer
